Province No,District,Name of Local Level,Population,Area sq.km.,Total no of Schools(Community),Total no of Schools(Institutional),Total no of Schools,Total no of Students of All Types Schools (Grade 1-12) Girls,Total no of Students of All Types Schools (Grade 1-12) Boys,Total no of Students of All Types Schools (Grade 1-12)
1,Taplejung,Aathrai Triveni RM,13784,88.83,35,2,37,2190,1911,4101
1,Taplejung,Phaktanglung RM,12017,1858.51,43,0,43,1653,1611,3264
1,Taplejung,Phungling MC,26406,125.57,51,12,63,2236,1975,4211
1,Taplejung,Mikwa Khola RM,9160,442.96,27,0,27,1561,1269,2830
1,Taplejung,Meringden RM,12548,210.33,36,0,36,2085,1812,3897
1,Taplejung,Maiwa Khola RM,11037,138,28,0,28,3598,3279,6877
1,Taplejung,Yangwarak RM,13591,93.76,36,0,36,2066,1906,3972
1,Taplejung,Sidingwa RM,12099,206,39,0,39,2835,2526,5361
1,Taplejung,Sirijangha RM,15806,481.09,42,0,42,2183,1998,4181
1,Panchthar,Kummayak RM,16118,129.3,39,4,43,3202,2873,6075
1,Panchthar,Tumbwa RM,13419,117.34,41,2,43,2040,1932,3972
1,Panchthar,Phalelung RM,21884,207.14,47,7,54,3878,3439,7317
1,Panchthar,Phalgunanda RM,24060,107.53,40,8,48,3495,3024,6519
1,Panchthar,Phidim MC,49201,192.5,80,14,94,4158,3911,8069
1,Panchthar,Miklajung RM,24715,166.61,56,10,66,7694,7252,14946
1,Panchthar,Yangwarak RM,18281,208.63,43,8,51,2301,2179,4480
1,Panchthar,Hilihang RM,22913,123.01,44,6,50,2934,2639,5573
1,Ilam,Ilam MC,48536,173.32,58,23,81,2404,2058,4462
1,Ilam,Chulachuli RM,20820,108.46,23,2,25,4863,4099,8962
1,Ilam,Deumai MC,32927,191.63,54,11,65,7107,6882,13989
1,Ilam,"Phakphokthum
RM",21619,108.79,42,6,48,4151,3859,8010
1,Ilam,Mai MC,32576,246.11,50,10,60,2498,2136,4634
1,Ilam,Maijogmai RM,21044,172.41,38,5,43,2697,2385,5082
1,Ilam,Mangsebung RM,18503,142.41,33,2,35,3328,2799,6127
1,Ilam,Rong RM,19135,155.06,31,0,31,1851,1516,3367
1,Ilam,Sandakpur RM,16065,156.01,32,3,35,1666,1404,3070
1,Ilam,Suryodaya MC,56691,252.52,71,24,95,7416,6218,13634
1,Jhapa,Arjundhara MC,60204,109.86,32,17,49,6258,6080,12338
1,Jhapa,Kachankabal RM,39535,109.45,33,4,37,4138,4065,8203
1,Jhapa,Kankai MC,40141,80.98,17,11,28,7802,8851,16653
1,Jhapa,Kamal RM,44365,104.57,27,17,44,14802,15121,29923
1,Jhapa,Gauradaha MC,53033,149.86,35,17,52,5453,5203,10656
1,Jhapa,Gauriganj RM,33038,101.35,26,10,36,7378,6916,14294
1,Jhapa,Jhapa RM,34601,94.12,40,7,47,6324,6082,12406
1,Jhapa,Damak MC,75102,70.86,25,25,50,3979,3832,7811
1,Jhapa,Bahradasi RM,33653,88.44,24,7,31,3560,3532,7092
1,Jhapa,Buddhashanti RM,41615,79.78,19,11,30,5325,5149,10474
1,Jhapa,Bhadrapur MC,65543,96.35,33,27,60,4529,4630,9159
1,Jhapa,Mechinagar MC,111797,192.85,43,46,89,5392,5129,10521
1,Jhapa,Birtamod MC,82592,78.24,26,55,81,4747,4763,9510
1,Jhapa,Shivasatakshi MC,64596,145.87,39,22,61,11992,11648,23640
1,Jhapa,Haldibari RM,29223,117.34,18,7,25,7696,7178,14874
1,Morang,Urlabari MC,54696,74.62,20,20,40,6655,6244,12899
1,Morang,Katahari RM,39775,51.59,20,3,23,18542,17426,35968
1,Morang,Kanepokhari RM,38033,82.83,18,4,22,3455,3283,6738
1,Morang,Kerabari RM,30431,219.83,27,6,33,5962,5608,11570
1,Morang,Gramthan RM,32717,71.84,23,5,28,2997,2760,5757
1,Morang,Jahada RM,41819,62.38,29,1,30,4411,4078,8489
1,Morang,Dhapalthan RM,39394,70.26,26,5,31,3082,2968,6050
1,Morang,Pathari Sanischare MC,62440,79.81,27,16,43,4021,3858,7879
1,Morang,Budhiganga RM,41586,56.41,19,8,27,4257,3820,8077
1,Morang,Belbari MC,65892,132.79,28,13,41,4485,4196,8681
1,Morang,Miklajung RM,28708,158.98,34,9,43,4024,3816,7840
1,Morang,Rangeli MC,52013,111.78,28,10,38,6482,6431,12913
1,Morang,Ratuwamai MC,55380,142.15,45,8,53,6229,5808,12037
1,Morang,Letang MC,32053,219.23,34,13,47,7280,6661,13941
1,Morang,Biratnagar MP,214663,77,83,38,121,4742,4428,9170
1,Morang,Sunbarshi MC,50758,106.4,41,7,48,8338,7981,16319
1,Morang,Sundarharicha MC,80518,110.16,42,18,60,7893,7409,15302
1,Sunsari,Itahari Sub-MP,140517,93.78,39,94,133,11027,9913,20940
1,Sunsari,Inaruwa MC,63593,77.92,40,28,68,3531,3273,6804
1,Sunsari,Koshi RM,43626,75.98,45,6,51,4476,4291,8767
1,Sunsari,Gadhi RM,34852,67.7,27,10,37,3372,3081,6453
1,Sunsari,Duhabi MC,56269,76.67,35,13,48,18938,17702,36640
1,Sunsari,Dewanganj RM,35073,53.56,29,3,32,7275,6599,13874
1,Sunsari,Dharan Sub-MP,137705,192.32,60,87,147,3387,3128,6515
1,Sunsari,Baraha MC,77408,222.09,59,29,88,5809,5805,11614
1,Sunsari,Barju RM,31178,69.43,30,4,34,7318,7738,15056
1,Sunsari,Bhokraha RM,40509,63.37,41,5,46,19559,19110,38669
1,Sunsari,Ramdhuni MC,51752,91.69,29,23,52,5483,5306,10789
1,Sunsari,Harinagara RM,40846,52.29,46,11,57,5885,5451,11336
1,Dhankuta,Khalsa Chhintang Sahidbhumi RM,18760,99.55,39,5,44,3061,2900,5961
1,Dhankuta,Chaubise RM,19283,147.6,52,6,58,2667,2342,5009
1,Dhankuta,"Chhathar Jorpati
RM",18322,102.83,33,7,40,7254,6703,13957
1,Dhankuta,Dhankuta MC,36619,111,42,20,62,3065,2618,5683
1,Dhankuta,Pakhribas MC,22078,144.29,37,5,42,4250,3663,7913
1,Dhankuta,Mahalaxmi MC,24800,129.39,53,4,57,2954,2720,5674
1,Dhankuta,Sanguri Gadi RM,21536,16644,54,4,58,3017,2590,5607
1,Terhathum,Atharai RM,21747,167.07,59,3,62,4041,3473,7514
1,Terhathum,Chhatha RM,16715,133.93,47,2,49,2704,2291,4995
1,Terhathum,Phedap RM,17700,110.83,43,5,48,2904,2656,5560
1,Terhathum,Menchayayem RM,8078,70.09,23,0,23,1441,1263,2704
1,Terhathum,Myanglung MC,19659,100.21,31,7,38,3427,3192,6619
1,Terhathum,Laligurans MC,16970,90.27,32,4,36,2623,2233,4856
1,Sankhuwasabha,Khandbari MC,31177,122.78,46,16,62,954,902,1856
1,Sankhuwasabha,Chichila RM,7065,88.63,21,0,21,1065,1089,2154
1,Sankhuwasabha,ChiMCur MC,27308,223.69,59,5,64,4085,3895,7980
1,Sankhuwasabha,Dharmadevi MC,18235,132.82,37,6,43,2700,2456,5156
1,Sankhuwasabha,Panchkhapan MC,17521,148.03,42,1,43,6004,5851,11855
1,Sankhuwasabha,Bhotkhola RM,6576,639.01,23,1,24,2231,2167,4398
1,Sankhuwasabha,Makalu RM,13204,519.45,46,2,48,2124,2095,4219
1,Sankhuwasabha,Madi MC,14470,110.1,35,3,38,2603,2397,5000
1,Sankhuwasabha,Sabhapokhari RM,10492,222.08,30,3,33,1802,1705,3507
1,Sankhuwasabha,Silichung RM,12174,293.26,40,1,41,1813,1668,3481
1,Bhojpur,Arun RM,17687,154.76,36,2,38,2691,2672,5363
1,Bhojpur,Aamchouk RM,18720,184.89,43,1,44,2570,2297,4867
1,Bhojpur,"Tyamke Mayung
RM",17911,173.41,46,1,47,4857,4384,9241
1,Bhojpur,"Pauwa Dumma
RM",15394,118.86,34,2,36,2243,2113,4356
1,Bhojpur,Bhojpur MC,27204,159.51,45,9,54,2305,2029,4334
1,Bhojpur,Ramprasad Rai RM,18848,158.83,34,1,35,2423,2340,4763
1,Bhojpur,Sadananda MC,31610,241.15,71,5,76,4629,4364,8993
1,Bhojpur,Salpa Silichho RM,13111,193.33,41,1,42,2277,2146,4423
1,Bhojpur,Hatuwagadhi RM,20404,142.61,39,1,40,2464,2290,4754
1,Solukhumbu,Khumbu Pasang Lamu RM,8989,1539.11,19,1,20,2851,2738,5589
1,Solukhumbu,Dudhkosi RM,13414,167.67,40,1,41,2199,1995,4194
1,Solukhumbu,Dudhkausika RM,19672,144.6,53,0,53,1252,1146,2398
1,Solukhumbu,Necha Salyan RM,16129,94.49,44,2,46,874,758,1632
1,Solukhumbu,Mahakulung RM,11452,648.05,19,0,19,2036,1904,3940
1,Solukhumbu,Likhu Pike RM,5534,124.38,22,0,22,2887,2726,5613
1,Solukhumbu,Sotang RM,9530,103,26,1,27,3423,3303,6726
1,Solukhumbu,Solu Dudhkunda MC,20399,538.09,64,4,68,2107,2075,4182
1,Okhaldhunga,Khiji Demba RM,15106,179.77,54,2,56,2997,2821,5818
1,Okhaldhunga,Champadevi RM,18613,126.91,42,0,42,2026,1888,3914
1,Okhaldhunga,Chisankhugadi RM,15196,126.91,44,1,45,3101,2852,5953
1,Okhaldhunga,"Manebhanjyang
RM",21082,146.61,46,3,49,2411,2304,4715
1,Okhaldhunga,Molung RM,15862,112,24,2,26,3019,2710,5729
1,Okhaldhunga,Likhu RM,14049,88.03,31,0,31,1482,1413,2895
1,Okhaldhunga,Siddicharan MC,28374,167.88,54,5,59,3222,2993,6215
1,Okhaldhunga,Sunkoshi RM,18550,143.75,39,4,43,2920,2766,5686
1,Khotang,Ainselukharka RM,16097,125.93,43,1,44,2480,2232,4712
1,Khotang,Kepilasgadi RM,15288,191.55,39,2,41,2278,2163,4441
1,Khotang,Khotehang RM,22474,164.09,51,1,52,3241,3161,6402
1,Khotang,Jantedhunga RM,15444,128.68,37,0,37,4956,4525,9481
1,Khotang,Diprung RM,20175,136.59,50,2,52,2607,2316,4923
1,Khotang,Rupakot Majhuwagadhi RM,46903,246.51,93,14,107,2335,2045,4380
1,Khotang,Lamidanda RM,13369,97.44,28,1,29,3862,3501,7363
1,Khotang,Barahapokhari RM,14349,141.57,35,0,35,1914,1859,3773
1,Khotang,Sakela RM,11594,79.99,28,1,29,8145,7865,16010
1,Khotang,Halesi Tuwachung MC,29532,280.17,89,1,90,1644,1501,3145
1,Udayapur,"Udayapurgadhi
RM",30731,269.51,61,1,62,6387,6088,12475
1,Udayapur,Katari MC,56146,424.89,84,18,102,7695,7304,14999
1,Udayapur,Chaudandigadhi MC,48574,283.78,49,22,71,9388,8935,18323
1,Udayapur,Tapli RM,14562,119.11,37,3,40,4055,3718,7773
1,Udayapur,Triyuga MC,87557,547.43,76,44,120,2154,1942,4096
1,Udayapur,Rautamai RM,23481,204.08,60,0,60,2619,2597,5216
1,Udayapur,Belaka MC,42386,344.73,52,14,66,14706,14138,28844
1,Udayapur,Sunkoshi RM,11992,106.8,32,0,32,4597,4476,9073
2,Saptari,Agnisair Krishna Sabran RM,27129,103.08,21,3,24,2777,2617,5394
2,Saptari,Kanchanrup MC,35238,117.34,31,4,35,2186,2079,4265
2,Saptari,Khadak MC,45367,96.77,43,2,45,3173,2875,6048
2,Saptari,Chhinnamasta RM,28370,38.71,22,3,25,4505,4476,8981
2,Saptari,Dakneshwari MC,44782,69.11,25,2,27,5030,4655,9685
2,Saptari,Tirahut RM,22010,37.81,10,2,12,2562,2289,4851
2,Saptari,Tilathi Koiladi RM,32389,32.91,21,2,23,5929,5431,11360
2,Saptari,Balan Bihul RM,26068,33.04,18,2,20,4983,4558,9541
2,Saptari,Bishnupur RM,19913,36.61,21,2,23,5188,4804,9992
2,Saptari,Belhi Chapena RM,29459,47.92,22,2,24,5184,4701,9885
2,Saptari,Bodebarsain MC,43229,58.93,32,4,36,2977,2747,5724
2,Saptari,Mahadewa RM,28542,34.97,18,2,20,7187,8002,15189
2,Saptari,Rajbiraj MC,69803,55.64,44,7,51,2874,2516,5390
2,Saptari,Rupani RM,26387,56.08,15,2,17,2604,2193,4797
2,Saptari,Shambhunath MC,38018,108.71,27,2,29,3543,3164,6707
2,Saptari,Saptakoshi RM,21131,60.25,13,4,17,4954,4298,9252
2,Saptari,Surunga MC,44221,107.04,35,2,37,4929,4466,9395
2,Saptari,Hanumannagar Kankalini MC,45734,118.19,31,4,35,1055,976,2031
2,Siraha,Arnama RM,22912,37.76,15,1,16,2744,2626,5370
2,Siraha,Aurahi RM,23046,35.87,15,2,17,2040,1884,3924
2,Siraha,Karjanha RM,30967,76.84,23,6,29,3419,3472,6891
2,Siraha,Kalyanpur MC,49288,76.81,37,12,49,2696,2556,5252
2,Siraha,Golbazaar MC,52137,111.94,31,24,55,2238,2256,4494
2,Siraha,Dhangadhimai MC,47449,159.51,34,17,51,6748,6748,13496
2,Siraha,Naraha RM,19369,29.28,14,5,19,7732,8043,15775
2,Siraha,Navarajpur RM,19019,32.18,20,1,21,5482,5281,10763
2,Siraha,Bariyarpatti RM,25256,37.72,24,6,30,4213,4208,8421
2,Siraha,Bhagawanpur RM,20957,33.03,16,3,19,13307,14264,27571
2,Siraha,Mirchaiya MC,50079,91.97,32,23,55,3509,3319,6828
2,Siraha,"Laxmipur Patari
RM",26913,42.33,19,5,24,8381,9066,17447
2,Siraha,Lahan MC,91766,167.17,67,46,113,2170,2268,4438
2,Siraha,Bishnupur RM,18522,26.34,13,5,18,2351,2313,4664
2,Siraha,Sakhuwanan karkatti RM,18558,32.84,19,1,20,1881,1695,3576
2,Siraha,Siraha MC,82531,94.2,64,41,105,12748,12948,25696
2,Siraha,Sukhipur RM,37592,54.78,29,9,38,5741,5471,11212
2,Dhanusha,Aaurahi RM,32578,25.56,10,3,13,2915,2574,5489
2,Dhanusha,"Kamala Siddhidatri
RM",38877,65.85,17,2,19,3325,2976,6301
2,Dhanusha,Kshireshwarnath MC,42541,50.85,24,0,24,3607,3502,7109
2,Dhanusha,Ganeshman Charnath MC,37300,244.31,20,2,22,2167,2015,4182
2,Dhanusha,Janak Nandani RM,25085,27.62,13,2,15,4872,4670,9542
2,Dhanusha,Janakpur Sub-MP,159468,91.97,61,13,74,3140,2974,6114
2,Dhanusha,Dhanushadham MC,45665,91.64,21,2,23,3133,2884,6017
2,Dhanusha,Dhanaugi RM,21395,22.13,10,1,11,3236,3221,6457
2,Dhanusha,Nagarain MC,35630,49,16,1,17,12173,11265,23438
2,Dhanusha,Bateshwar RM,21530,31.66,21,1,22,3960,3610,7570
2,Dhanusha,Mithila MC,45164,187.93,29,2,31,4430,4102,8532
2,Dhanusha,Mithila Bihari RM,33521,37.6,15,1,16,4219,3978,8197
2,Dhanusha,Mukhiyapatti Musarniya RM,25482,26.84,10,1,11,4903,4576,9479
2,Dhanusha,Laxminiya RM,28251,30.66,24,1,25,3993,3460,7453
2,Dhanusha,Bideha MC,32266,45.51,15,4,19,3341,3128,6469
2,Dhanusha,Sahidnagar MC,43007,57.37,30,6,36,3869,3586,7455
2,Dhanusha,Sabaila MC,45879,64.47,26,2,28,5845,5243,11088
2,Dhanusha,Hanshapur RM,39145,48.71,23,1,24,6387,5996,12383
2,Mahottari,Ekdara RM,29315,24,17,2,19,4286,3969,8255
2,Mahottari,Aurahi RM,31751,35.76,17,1,18,6069,5665,11734
2,Mahottari,Gaushala MC,66673,144.73,36,14,50,8940,8371,17311
2,Mahottari,Jaleshwar MC,58549,44.26,38,13,51,7062,6762,13824
2,Mahottari,Pipara RM,35524,39.98,23,3,26,4544,4356,8900
2,Mahottari,Bardibas MC,66358,315.57,56,11,67,9846,9305,19151
2,Mahottari,Balwa RM,42341,44.07,29,3,32,8785,8548,17333
2,Mahottari,Bhangaha MC,46757,77.21,37,3,40,5969,5739,11708
2,Mahottari,Mathiyani RM,31026,29.02,14,2,16,3308,3196,6504
2,Mahottari,Manara Siswa MC,49692,49.73,27,3,30,5898,5723,11621
2,Mahottari,Mahottari RM,27430,28.08,12,0,12,3261,3150,6411
2,Mahottari,Ram Gopalpur RM,29606,39.54,18,3,21,5035,5105,10140
2,Mahottari,Loharpatti RM,39579,50.06,22,6,28,4715,4424,9139
2,Mahottari,Samsi RM,33791,21.57,11,2,13,4024,3592,7616
2,Mahottari,Sonama RM,38747,57.77,18,1,19,5317,5128,10445
2,Sarlahi,Ishwarpur MC,59986,163.83,47,7,54,2267,2079,4346
2,Sarlahi,Kabilashi RM,42336,48.11,15,1,16,4969,4902,9871
2,Sarlahi,Kaudena RM,26085,25.33,14,0,14,7849,7430,15279
2,Sarlahi,Godaita MC,47687,48.62,23,3,26,2214,2020,4234
2,Sarlahi,Chhakraghata RM,27952,25.16,15,0,15,2571,2534,5105
2,Sarlahi,Chandranagar RM,33328,47.5,11,1,12,3724,3453,7177
2,Sarlahi,Dhankaul RM,24788,45.94,7,0,7,3036,2864,5900
2,Sarlahi,Parsa RM,21650,23.12,13,1,14,4107,3789,7896
2,Sarlahi,Barahathawa MC,69822,107.05,35,17,52,1737,1591,3328
2,Sarlahi,Balara MC,45194,48.55,27,0,27,7254,6682,13936
2,Sarlahi,Basbariya RM,23568,29.42,12,0,12,6277,5714,11991
2,Sarlahi,Bagmati MC,40399,101.18,14,2,16,6882,6382,13264
2,Sarlahi,Brahmapuri RM,29832,33.89,7,0,7,4961,4525,9486
2,Sarlahi,Malangwa MC,46516,30.44,23,11,34,9770,9146,18916
2,Sarlahi,Ramnagar RM,28727,26.44,18,0,18,3743,3480,7223
2,Sarlahi,Lalbandi MC,59395,238.5,52,13,65,3389,3309,6698
2,Sarlahi,Bishnupur RM,24748,28.09,7,0,7,8942,8515,17457
2,Sarlahi,Haripur MC,37351,66.86,21,1,22,6003,6034,12037
2,Sarlahi,Haripurwa MC,36042,30.5,14,0,14,2728,2413,5141
2,Sarlahi,Harion MC,43924,86.12,30,13,43,4095,3912,8007
2,Rautahat,Isnatha RM,41435,35.17,29,2,31,952,862,1814
2,Rautahat,Kathariya RM,38413,40.69,24,2,26,4310,4175,8485
2,Rautahat,Gadhimai RM,40410,49.44,25,2,27,6178,5902,12080
2,Rautahat,Garuda MC,50481,44.46,30,2,32,1207,1182,2389
2,Rautahat,Gujara RM,46592,150.33,27,2,29,2908,2880,5788
2,Rautahat,Gaur MC,34937,21.53,30,2,32,2750,2688,5438
2,Rautahat,Chandrapur MC,72059,249.96,52,3,55,3626,3617,7243
2,Rautahat,"Durga Bhagwati
RM",22599,19.18,23,2,25,6088,6224,12312
2,Rautahat,"Dewahi Gonahi
RM",32143,33.99,17,4,21,5528,5591,11119
2,Rautahat,Paroha RM,37453,37.45,23,4,27,3879,3566,7445
2,Rautahat,"Fathuha Bijaypur
RM",36533,65.24,22,4,26,4966,4768,9734
2,Rautahat,Birindaban RM,42735,95.4,23,4,27,4385,4486,8871
2,Rautahat,Baudhimai RM,36265,35.34,12,4,16,2962,2858,5820
2,Rautahat,"Madhavnarayan
RM",35175,48.53,22,2,24,2168,2136,4304
2,Rautahat,Maulapur RM,26431,34.75,24,2,26,3688,3784,7472
2,Rautahat,Yamunamai RM,23884,16.7,17,2,19,2599,2480,5079
2,Rautahat,Rajdevi MC,31292,28.21,22,2,24,3453,3228,6681
2,Rautahat,Rajpur RM,41078,31.41,21,2,23,2125,1976,4101
2,Bara,"Adarsha Kotwal
RM",27552,36.25,14,2,16,3486,3287,6773
2,Bara,Karaiyamai RM,26400,47.69,21,1,22,3469,3261,6730
2,Bara,Kalaiya Sub-MP,123659,108.94,67,2,69,1533,1449,2982
2,Bara,Kolhawi MC,43036,157.4,40,1,41,14040,13035,27075
2,Bara,Jitpur-Simara Sub-MP,117496,312.18,61,5,66,16045,15095,31140
2,Bara,Devtaal RM,23223,23.31,11,1,12,3435,3082,6517
2,Bara,Nijgadh MC,35335,289.43,29,1,30,8165,7292,15457
2,Bara,Pachrauta MC,34175,44.01,18,1,19,10286,9638,19924
2,Bara,Parwanipur RM,22787,15.48,6,2,8,6705,6059,12764
2,Bara,Prasauni RM,25478,20.24,9,1,10,3185,3116,6301
2,Bara,Pheta RM,26705,23.65,21,1,22,1709,1675,3384
2,Bara,Baragadhi RM,27191,39.29,19,2,21,5262,5035,10297
2,Bara,Mahagadhimai MC,54474,55.32,46,2,48,2470,2284,4754
2,Bara,Vishrampur RM,23785,19.81,10,0,10,7140,7265,14405
2,Bara,Simraungadh MC,49939,42.65,28,1,29,3419,3205,6624
2,Bara,Subarna RM,29602,36.84,19,1,20,2641,2438,5079
2,Parsa,Kalikamai RM,21131,24.33,13,1,14,4471,4251,8722
2,Parsa,Chhipaharmai RM,26671,24.9,13,1,14,1585,1464,3049
2,Parsa,Jagarnnathpur RM,31591,45.29,31,1,32,21579,19868,41447
2,Parsa,Jirabhawani RM,22765,55.39,24,1,25,2825,2826,5651
2,Parsa,Thori RM,20396,128.67,24,2,26,1267,1199,2466
2,Parsa,Dhobini RM,19911,24.41,11,1,12,3157,2907,6064
2,Parsa,"Pakahamainpur
RM",20717,21.26,16,1,17,2879,2674,5553
2,Parsa,"Paterwa Sugauli
RM",23901,64.29,29,1,30,2848,2560,5408
2,Parsa,Parsagadhi RM,38607,99.69,30,3,33,2489,2397,4886
2,Parsa,Pokhariya MC,32885,32.47,27,1,28,4927,4708,9635
2,Parsa,Bahudarmai RM,39673,31.55,21,1,22,4395,4023,8418
2,Parsa,Bindabasini RM,24468,26.04,10,1,11,4123,3923,8046
2,Parsa,Birgunj MP,240922,132.07,95,6,101,4860,4473,9333
2,Parsa,"Sakhuwa Prasauni
RM",32448,74.27,28,1,29,2993,2619,5612
3,Sindhuli,Kamalamai MC,65064,482.57,101,24,125,10385,9783,20168
3,Sindhuli,Golanjor RM,19329,184.13,57,2,59,2202,2113,4315
3,Sindhuli,Ghyanglekh RM,13661,166.77,31,2,33,3645,3349,6994
3,Sindhuli,TiMCatan RM,38395,280.26,87,7,94,4292,4171,8463
3,Sindhuli,Dudhouli MC,65302,390.39,80,11,91,11367,10942,22309
3,Sindhuli,Phikkal RM,16968,186.06,47,0,47,5019,4671,9690
3,Sindhuli,Marin RM,27822,324.55,47,1,48,3645,3353,6998
3,Sindhuli,Sunkoshi RM,21473,154.68,52,2,54,3650,3326,6976
3,Sindhuli,"Hariharpurgadhi
RM",27727,343.9,48,0,48,6317,5992,12309
3,Ramechhap,Uma Kunda RM,17601,451.99,50,3,53,3148,2946,6094
3,Ramechhap,Khada Devi RM,25761,150.7,71,3,74,2676,2471,5147
3,Ramechhap,Gokul Ganga RM,20058,198.4,45,2,47,3492,2970,6462
3,Ramechhap,Doramba RM,22738,140.88,53,2,55,3552,3236,6788
3,Ramechhap,Manthali MC,45416,211.78,87,2,89,6624,6148,12772
3,Ramechhap,Ramechhap MC,28612,202.45,64,3,67,3938,3599,7537
3,Ramechhap,Likhu RM,23109,124.51,53,2,55,2450,2188,4638
3,Ramechhap,Sunapati RM,18141,86.98,43,2,45,2702,2524,5226
3,Dolakha,Kalinchock RM,22957,132.49,54,3,57,2924,2692,5616
3,Dolakha,Gaurisankar RM,17062,681.39,49,2,51,4050,3581,7631
3,Dolakha,Jiri MC,15515,211.27,35,5,40,2905,2645,5550
3,Dolakha,Tamakoshi RM,18849,153.06,46,1,47,2623,2309,4932
3,Dolakha,Bhimeshor MC,32480,132.5,49,7,56,2688,2285,4973
3,Dolakha,Melung RM,20210,86.54,47,3,50,3818,3531,7349
3,Dolakha,Bigu RM,18449,663.2,42,2,44,3312,2800,6112
3,Dolakha,Baiteshor RM,19876,80.41,36,1,37,2597,2327,4924
3,Dolakha,Sailung RM,20098,128.67,44,1,45,2839,2658,5497
3,Sindhupalchok,Indrawati RM,28517,105.09,59,0,59,2556,2370,4926
3,Sindhupalchok,Chautara Sangachokgadhi MC,46501,165.25,86,5,91,3882,3779,7661
3,Sindhupalchok,Jugal RM,19231,273.62,45,0,45,1784,1653,3437
3,Sindhupalchok,Tripurasundari RM,15062,94.28,31,0,31,7802,6811,14613
3,Sindhupalchok,Panchpokhari Thanpal RM,20860,187.29,34,0,34,2797,2524,5321
3,Sindhupalchok,Balephi RM,18909,61.6,36,3,39,4592,4307,8899
3,Sindhupalchok,Barhabise MC,26700,96.73,52,5,57,3663,3587,7250
3,Sindhupalchok,Bhotekoshi RM,17156,278.31,32,2,34,1480,1442,2922
3,Sindhupalchok,Melamchi MC,45343,158.17,73,4,77,6093,5634,11727
3,Sindhupalchok,"Lisankhupakhar
RM",15155,98.61,31,0,31,2979,2904,5883
3,Sindhupalchok,Sunkoshi RM,16713,72.84,31,3,34,2442,2228,4670
3,Sindhupalchok,Helambu RM,17671,287.26,36,2,38,1915,1609,3524
3,Kavrepalanchok,Khanikhola RM,14398,132,37,5,42,8815,8664,17479
3,Kavrepalanchok,Chaurideurali RM,20829,98,57,5,62,2418,2177,4595
3,Kavrepalanchok,Timal RM,22712,89,49,5,54,2778,2515,5293
3,Kavrepalanchok,Dhulikhel MC,32162,55,27,8,35,3485,3060,6545
3,Kavrepalanchok,Namobuddha MC,29519,102,50,5,55,2191,1854,4045
3,Kavrepalanchok,Panauti MC,46595,118,39,11,50,3156,2896,6052
3,Kavrepalanchok,Panchkhal MC,37997,103,37,16,53,3816,3847,7663
3,Kavrepalanchok,Banepa MC,55628,55,43,28,71,4348,3934,8282
3,Kavrepalanchok,Bethanchowk RM,16777,101,31,2,33,3174,2739,5913
3,Kavrepalanchok,Bhumlu RM,18916,91,49,7,56,4538,4162,8700
3,Kavrepalanchok,Mandandeupur MC,32659,89,47,11,58,5116,4890,10006
3,Kavrepalanchok,Mahabharat RM,18283,186,51,3,54,5044,4447,9491
3,Kavrepalanchok,Roshi RM,28746,176,72,7,79,3070,2533,5603
3,Lalitpur,Konjyosom RM,9709,44.16,15,4,19,2204,2049,4253
3,Lalitpur,Godawari MC,78301,96.11,35,50,85,10550,10408,20958
3,Lalitpur,Bagmati RM,13049,111.49,46,3,49,1246,1186,2432
3,Lalitpur,Mahankal RM,9453,82.47,24,4,28,40697,41047,81744
3,Lalitpur,Mahalaxmi MC,62172,26.51,14,37,51,7887,8068,15955
3,Lalitpur,Lalitpur MP,284922,36.12,50,193,243,1301,1266,2567
3,Bhaktapur,Changunarayan MC,55430,62.98,36,35,71,14773,15570,30343
3,Bhaktapur,Bhaktapur MP,81728,6.89,36,69,105,4382,4069,8451
3,Bhaktapur,Madhyapur Thimi MC,83036,11.47,17,57,74,8944,9101,18045
3,Bhaktapur,Suryabinayak MC,78490,42.45,41,53,94,7524,7535,15059
3,Kathmandu,"Kageshwori
Manohara MC",60237,27.38,13,36,49,6578,6860,13438
3,Kathmandu,Kathmandu MP,975453,49.45,135,638,773,11672,11492,23164
3,Kathmandu,Kirtipur MC,65602,14.76,13,24,37,3034,3055,6089
3,Kathmandu,Gokarneshwor MC,107351,58.5,15,85,100,16613,17229,33842
3,Kathmandu,Chandragiri MC,85198,43.92,24,54,78,9168,9104,18272
3,Kathmandu,Tokha MC,99032,17.11,10,72,82,105053,113501,218554
3,Kathmandu,Tarkeshwor MC,81443,54.95,23,51,74,6418,7235,13653
3,Kathmandu,Daxinkali MC,24296,42.68,24,8,32,6716,7186,13902
3,Kathmandu,Nagarjuna MC,67420,29.85,15,39,54,3098,2983,6081
3,Kathmandu,Budhanilkantha MC,107918,34.8,9,45,54,10954,11239,22193
3,Kathmandu,Shankharapur MC,25338,60.21,21,8,29,12762,12701,25463
3,Nuwakot,Kakani RM,27073,87.97,47,2,49,6097,5576,11673
3,Nuwakot,Kispang RM,14861,82.57,24,0,24,8570,8347,16917
3,Nuwakot,Tadi RM,17932,69.8,36,0,36,3317,3213,6530
3,Nuwakot,Tarkeshwor RM,15719,72.62,35,0,35,3909,3581,7490
3,Nuwakot,Dupcheshwor RM,22106,131.62,52,0,52,1858,1683,3541
3,Nuwakot,Panchakanya RM,15945,53.47,29,0,29,1884,1684,3568
3,Nuwakot,Belkotgadi MC,39888,155.6,55,5,60,2116,1839,3955
3,Nuwakot,Meghang RM,13479,97.83,25,0,25,1773,1698,3471
3,Nuwakot,Likhu RM,16852,47.88,21,1,22,2903,2453,5356
3,Nuwakot,Bidur MC,54351,130.01,69,21,90,2586,2308,4894
3,Nuwakot,Shivapuri RM,20769,101.5,52,0,52,2582,2442,5024
3,Nuwakot,Suryagadi RM,16800,49.09,31,2,33,2195,2153,4348
3,Rasuwa,Uttargaya RM,8255,104.51,21,2,23,869,779,1648
3,Rasuwa,Kalika RM,9421,192.54,22,1,23,1504,1412,2916
3,Rasuwa,Gosaikunda RM,7143,978.77,18,1,19,1757,1643,3400
3,Rasuwa,Naukunda RM,11824,126.99,29,0,29,629,528,1157
3,Rasuwa,Parwatikunda RM,5490,628.23,12,0,12,1086,902,1988
3,Dhading,Khaniyabash RM,12749,120.8,28,3,31,5973,5334,11307
3,Dhading,Ganga Jamuna RM,21784,152.72,47,3,50,3525,3259,6784
3,Dhading,Gajuri RM,27084,138.66,47,3,50,3557,3444,7001
3,Dhading,Galchi RM,27784,129.08,42,4,46,3076,2913,5989
3,Dhading,Jwalamukhi RM,23966,114.04,42,4,46,3404,3195,6599
3,Dhading,"Tripurasundary
RM",22960,271.22,34,4,38,3253,2846,6099
3,Dhading,Thakre RM,32914,96.41,43,6,49,1791,1580,3371
3,Dhading,Dhunibesi MC,31029,96.3,41,8,49,9719,9092,18811
3,Dhading,Neelakantha MC,58515,197.7,96,8,104,1655,1496,3151
3,Dhading,Netrawati RM,12870,181.78,27,3,30,1305,1299,2604
3,Dhading,"Benighat Rorang
RM",31475,206.52,75,4,79,3474,3100,6574
3,Dhading,Rubivalley RM,9565,401.85,23,3,26,4209,3805,8014
3,Dhading,Shiddhaekh RM,23729,106.09,49,3,52,2736,2354,5090
3,Makwanpur,Indrasarowar MC,17585,97.34,24,6,30,5074,4927,10001
3,Makwanpur,Kailash RM,23922,204.48,51,6,57,7017,6678,13695
3,Makwanpur,Thaha MC,41623,191.12,57,9,66,3607,3258,6865
3,Makwanpur,Bakaiya RM,39620,393.75,75,6,81,17102,15628,32730
3,Makwanpur,Bagmati RM,30495,311.79,50,7,57,1608,1378,2986
3,Makwanpur,Bhimphedi RM,23344,245.27,52,7,59,3946,3762,7708
3,Makwanpur,"Makwanpurgadhi
RM",25322,148.72,39,6,45,3563,3223,6786
3,Makwanpur,Manahari RM,38399,199.52,32,7,39,6798,6205,13003
3,Makwanpur,Raksirang RM,26192,226.7,54,6,60,4039,3876,7915
3,Makwanpur,Hetauda Sub-MP,152875,261.59,86,14,100,5851,5250,11101
3,Chitwan,"Ichchhakamana
RM",25012,166.73,58,4,62,43884,42778,86662
3,Chitwan,Kalika MC,41742,149.08,38,12,50,4138,3932,8070
3,Chitwan,Khairahani MC,56094,85.55,29,22,51,5365,5188,10553
3,Chitwan,Bharatpur MC,280502,432.95,125,101,226,6606,6769,13375
3,Chitwan,Madi MC,37683,218.24,45,10,55,4543,4356,8899
3,Chitwan,Ratnanagar MC,69848,68.68,33,24,57,7867,7742,15609
3,Chitwan,Rapti MC,57107,212.31,54,12,66,11666,11277,22943
4,Gorkha,Ajirkot RM,14802,198.05,32,3,35,3925,3554,7479
4,Gorkha,Aarughat RM,23887,160.79,42,3,45,2262,2131,4393
4,Gorkha,Gandaki RM,23253,123.86,49,1,50,3713,3448,7161
4,Gorkha,Gorkha MC,49272,131.86,59,16,75,894,837,1731
4,Gorkha,Chumnubri RM,6923,1648.65,24,1,25,2099,1889,3988
4,Gorkha,Dharche RM,13229,651.52,27,2,29,3648,3261,6909
4,Gorkha,Palungtar MC,38174,158.62,50,12,62,10035,9117,19152
4,Gorkha,Bhimsen RM,22033,101.25,45,4,49,5879,5445,11324
4,Gorkha,Shahid Lakhan RM,27555,148.97,53,3,56,3105,2729,5834
4,Gorkha,Siranchowk RM,23628,121.64,52,4,56,3470,3129,6599
4,Gorkha,Sulikot RM,25389,200.63,51,2,53,4111,3720,7831
4,Lamjung,Kolasothar RM,10032,175.37,30,0,30,6778,6325,13103
4,Lamjung,Dhudh Pokhari RM,10975,153.33,35,0,35,1527,1383,2910
4,Lamjung,Dordi RM,18392,350.93,55,0,55,2390,2091,4481
4,Lamjung,Besisahar MC,39356,127.64,60,13,73,1288,1158,2446
4,Lamjung,Madhya Nepal MC,23385,113.86,48,7,55,4307,3934,8241
4,Lamjung,Marsyandi RM,18759,597.25,58,1,59,2698,2385,5083
4,Lamjung,Rainas MC,18527,71.97,39,4,43,2748,2457,5205
4,Lamjung,Sundarbazar MC,26861,72.05,44,9,53,5128,5118,10246
4,Tanahu,Anbukhaireni MC,20768,128,41,10,51,3927,3679,7606
4,Tanahu,Rishinga RM,25870,215,50,6,56,3360,3237,6597
4,Tanahu,Ghiring RM,19318,126,40,7,47,5637,5277,10914
4,Tanahu,Devghat RM,16131,159,45,5,50,4381,4083,8464
4,Tanahu,Bhanu MC,45792,184,72,20,92,11009,10535,21544
4,Tanahu,Bhimad MC,31362,129,54,13,67,2117,2122,4239
4,Tanahu,Myagde RM,22502,115,35,4,39,2394,2216,4610
4,Tanahu,Bandipur RM,20013,102,41,9,50,2438,2373,4811
4,Tanahu,Byas MC,70335,248,88,42,130,3134,2872,6006
4,Tanahu,Suklagandaki MC,48456,165,66,19,85,7488,7339,14827
4,Syangja,Arjunchaupari RM,16176,57.22,33,11,44,2242,2102,4344
4,Syangja,Adhikola RM,16589,69.61,41,10,51,2116,1983,4099
4,Syangja,Kaligandaki RM,21728,73.51,36,12,48,3505,3513,7018
4,Syangja,Galayang MC,36967,122.71,60,16,76,2095,1920,4015
4,Syangja,Chapakot MC,26042,120.59,56,11,67,3886,3521,7407
4,Syangja,Putalibazar MC,44876,147.21,74,23,97,1754,1663,3417
4,Syangja,Fedhikhola RM,12341,56.73,27,10,37,5153,4864,10017
4,Syangja,Biruwa RM,18413,95.79,34,11,45,2045,1900,3945
4,Syangja,Bhirkot MC,25583,78.23,48,14,62,2487,2425,4912
4,Syangja,Walling MC,51143,128.4,81,20,101,6962,6310,13272
4,Syangja,Harinas RM,17343,87.48,31,8,39,6303,6238,12541
4,Kaski,Annapurna RM,23417,33.33,54,5,59,3421,3393,6814
4,Kaski,"Pokhara Lekhnath
MP",414141,464.24,223,205,428,3257,2920,6177
4,Kaski,"Machhapuchhre
RM",21868,544.58,48,10,58,2379,2228,4607
4,Kaski,Madi RM,18153,563,55,1,56,64600,67325,131925
4,Kaski,Rupa RM,14519,94.81,36,4,40,1737,1601,3338
4,Manang,Chame RM,1129,78.86,6,0,6,163,133,296
4,Manang,Narfu RM,538,837.54,2,0,2,27,26,53
4,Manang,Nashong RM,1938,709.58,11,0,11,247,192,439
4,Manang,Neshyang RM,2222,694.63,8,1,9,113,88,201
4,Mustang,Gharpojang RM,3029,316,7,3,10,204,187,391
4,Mustang,Thasang RM,2912,289,12,1,13,140,133,273
4,Mustang,Dalomey RM,1423,1344,11,1,12,355,316,671
4,Mustang,Lomanthan RM,1899,727,13,3,16,251,219,470
4,Mustang,Baragaun Muktichhetra RM,2330,886,17,1,18,363,421,784
4,Myagdi,Annapurna RM,13315,556.41,38,2,40,2021,1778,3799
4,Myagdi,Dhaulagiri RM,14104,1037,28,3,31,6536,6056,12592
4,Myagdi,Beni MC,33894,76.57,60,13,73,2118,1999,4117
4,Myagdi,Mangal RM,16286,89,43,4,47,2236,2108,4344
4,Myagdi,Malika RM,19458,147,34,5,39,2168,1956,4124
4,Myagdi,Raghuganga RM,15753,379,33,3,36,1580,1391,2971
4,Parbat,Kushma MC,39600,93.18,68,13,81,2201,1976,4177
4,Parbat,Jaljala RM,21454,82.26,46,8,54,2612,2420,5032
4,Parbat,Painyu RM,15381,42.65,30,6,36,6384,5938,12322
4,Parbat,Phalewas MC,24687,85.7,58,9,67,1423,1401,2824
4,Parbat,Mahashila RM,9857,49.38,30,1,31,3419,2948,6367
4,Parbat,Modi RM,21284,143.6,54,4,58,2111,1832,3943
4,Parbat,Bihadi RM,13403,44.8,31,4,35,3955,3500,7455
4,Baglung,Kathekhola RM,22865,82.88,54,7,61,5985,5603,11588
4,Baglung,Galkot MC,33097,194.39,73,9,82,10678,10700,21378
4,Baglung,Jaimini MC,31430,118.71,77,6,83,2701,2398,5099
4,Baglung,Dhorpatan MC,26215,222.85,42,4,46,5982,5607,11589
4,Baglung,Taman Khola RM,10659,178.02,16,7,23,6575,5987,12562
4,Baglung,Tarakhola Rular MC,12009,129.53,18,6,24,5209,4688,9897
4,Baglung,Nisikhola RM,20611,244.37,39,6,45,3772,3598,7370
4,Baglung,Baglung MC,57823,98.01,111,8,119,4458,3948,8406
4,Baglung,Badigad RM,30906,178.68,62,6,68,1566,1448,3014
4,Baglung,Barang RM,14492,75.28,32,6,38,1766,1737,3503
4,Nawalparasi_ East,Kawasoti MC,62421,108.34,37,24,61,4892,4524,9416
4,Nawalparasi_ East,Gaidakot MC,58836,159.93,31,19,50,2652,2398,5050
4,Nawalparasi_ East,Devchuli MC,42603,112.72,28,16,44,2401,2265,4666
4,Nawalparasi_ East,Bungdikali RM,15734,91.87,32,2,34,5995,6065,12060
4,Nawalparasi_ East,Bulingtar RM,19122,147.68,44,1,45,9970,9984,19954
4,Nawalparasi_ East,Madhyabindu MC,54140,233.35,41,16,57,4026,3858,7884
4,Nawalparasi_ East,Binayatriveni RM,25036,267.13,37,9,46,9390,9185,18575
4,Nawalparasi_ East,Hupsekot MC,25065,189.21,36,7,43,7143,6696,13839
5,Gulmi,Isma RM,20964,81.88,41,3,44,3205,3236,6441
5,Gulmi,Kaligandaki RM,18876,101.04,44,3,47,3225,3128,6353
5,Gulmi,Darbar RM,22037,79.99,31,5,36,3056,2987,6043
5,Gulmi,Chandrakot RM,21827,105.73,45,5,50,2703,2624,5327
5,Gulmi,Chhatrakot RM,21481,87.01,46,7,53,3101,2950,6051
5,Gulmi,Dhurkot RM,22457,86.32,49,3,52,2800,2770,5570
5,Gulmi,Madane RM,21899,94.52,49,3,52,3587,3371,6958
5,Gulmi,Malika RM,21729,92.49,55,5,60,3728,3684,7412
5,Gulmi,Musikot MC,32802,114.74,63,6,69,4899,4752,9651
5,Gulmi,Ruru RM,18581,67.38,49,4,53,4912,4876,9788
5,Gulmi,Resunga MC,32548,83.74,36,9,45,2641,2661,5302
5,Gulmi,Satyabati RM,23807,115.92,46,7,53,2938,2763,5701
5,Palpa,Tansen MC,50405,109.8,53,23,76,2291,2182,4473
5,Palpa,Tinahu RM,19085,202,39,1,40,3445,3373,6818
5,Palpa,Nisdi RM,22611,194.5,54,0,54,3435,3226,6661
5,Palpa,Purvakhola RM,19589,138.05,37,5,42,3322,3004,6326
5,Palpa,Bagnaskali RM,21361,84.17,31,8,39,4522,4210,8732
5,Palpa,Mathagadi RM,25017,215.49,41,4,45,6935,6561,13496
5,Palpa,Ramva RM,20190,94.12,37,5,42,2873,2570,5443
5,Palpa,Rampur MC,35396,123.34,51,9,60,2514,2242,4756
5,Palpa,Ribdikot RM,18770,124.55,37,2,39,9219,8772,17991
5,Palpa,Rainadevi Chhahara RM,26469,175.88,61,1,62,2842,2808,5650
5,Nawalparasi_ West,Palinandan RM,35429,44.67,25,15,40,9923,10011,19934
5,Nawalparasi_ West,Pratappur RM,41315,87.55,20,14,34,4508,4399,8907
5,Nawalparasi_ West,Bardaghat MC,55382,162.05,40,31,71,4954,4837,9791
5,Nawalparasi_ West,Ramgram MC,59455,128.32,30,31,61,8106,7999,16105
5,Nawalparasi_ West,Sarawal RM,38163,73.19,23,12,35,4312,4125,8437
5,Nawalparasi_ West,Sunwal MC,55424,139.1,34,20,54,6803,6511,13314
5,Nawalparasi_ West,Susta RM,43797,112.17,25,16,41,5640,5453,11093
5,Rupandehi,Om Satiya RM,34191,48.54,22,9,31,22934,26831,49765
5,Rupandehi,Kanchan RM,33072,58.51,19,6,25,7747,7650,15397
5,Rupandehi,Kotaimai RM,41006,58.26,21,3,24,5778,5858,11636
5,Rupandehi,Gaidahawa RM,47565,96.79,31,5,36,5618,5742,11360
5,Rupandehi,Tilottama MC,100149,126.19,48,36,84,4584,4463,9047
5,Rupandehi,Devdaha MC,53523,136.95,33,10,43,8397,9039,17436
5,Rupandehi,Butawal Sub-MP,138742,101.61,41,57,98,4891,4942,9833
5,Rupandehi,Marchawari RM,38776,48.55,20,7,27,5725,5890,11615
5,Rupandehi,Mayadevi RM,47196,72.44,29,19,48,2810,2716,5526
5,Rupandehi,Rohini RM,37175,64.62,29,7,36,4571,4247,8818
5,Rupandehi,Lumbini MC,72497,112.21,64,15,79,8975,8530,17505
5,Rupandehi,Suddhodhan RM,34638,57.66,18,3,21,4543,4371,8914
5,Rupandehi,Sammarimai RM,38305,50.78,34,9,43,9655,10413,20068
5,Rupandehi,Siddarthanagar MC,63483,36.03,28,31,59,5184,4954,10138
5,Rupandehi,Siyari RM,38466,66.17,30,8,38,5105,4686,9791
5,Rupandehi,Sainamaina MC,76394,162.18,24,14,38,14596,14998,29594
5,Kapilbastu,Kapilvastu MC,76394,136.91,60,19,79,10723,10460,21183
5,Kapilbastu,Krishnanagar MC,62370,96.66,49,4,53,9361,8926,18287
5,Kapilbastu,Banaganga MC,75242,233.68,49,18,67,8676,8796,17472
5,Kapilbastu,Buddhabhumi MC,64949,366.67,57,12,69,6837,6800,13637
5,Kapilbastu,Maharjganj MC,54800,112.21,74,6,80,7443,7394,14837
5,Kapilbastu,Mayadevi RM,48218,88.53,50,11,61,4738,4838,9576
5,Kapilbastu,Yashodhara RM,38952,67.56,42,1,43,10844,10899,21743
5,Kapilbastu,Vijayanagar RM,36937,173.19,41,2,43,4895,4868,9763
5,Kapilbastu,Shivaraj MC,66781,284.07,69,18,87,6667,6764,13431
5,Kapilbastu,Shuddhodhan RM,45201,91.69,34,1,35,4160,4060,8220
5,Arghakhanchi,Chhatradev RM,25336,87.62,42,7,49,4704,4318,9022
5,Arghakhanchi,Panini RM,26424,151.42,57,5,62,3372,3217,6589
5,Arghakhanchi,Bhumekasthan MC,32640,159.13,64,5,69,4722,4539,9261
5,Arghakhanchi,Malarani RM,28044,101.06,61,7,68,4011,3708,7719
5,Arghakhanchi,Sitganga MC,43373,610.43,109,7,116,6259,6170,12429
5,Arghakhanchi,Sandhikharka MC,41079,129.42,65,14,79,5924,5866,11790
5,Pyuthan,Airawoti RM,22392,156.75,44,4,48,3478,3299,6777
5,Pyuthan,Gaumukhi RM,25421,139.04,41,0,41,4585,4395,8980
5,Pyuthan,Jhimruk RM,27931,106.93,49,6,55,4352,4182,8534
5,Pyuthan,Naubahini RM,30292,213.41,39,4,43,2839,2677,5516
5,Pyuthan,Pyuthan MC,38449,128.96,51,12,63,2814,2687,5501
5,Pyuthan,Mallarani RM,17686,80.09,25,2,27,5214,4966,10180
5,Pyuthan,Mandavi RM,15058,113.08,26,1,27,6631,6534,13165
5,Pyuthan,Sarumarani RM,18627,157.97,26,1,27,3584,3568,7152
5,Pyuthan,Swargadwari MC,30940,224.7,55,10,65,5513,5220,10733
5,Rolpa,Tirbeni RM,22957,205.39,41,5,46,3453,3281,6734
5,Rolpa,Thawang RM,10881,191.07,21,1,22,4411,4282,8693
5,Rolpa,Duikholi RM,20778,163.01,43,2,45,2856,2802,5658
5,Rolpa,Madi RM,17986,129.05,33,2,35,5586,5401,10987
5,Rolpa,Runtigadhi RM,27929,232.69,55,3,58,4711,4374,9085
5,Rolpa,Rolpa MC,32759,270.42,67,7,74,5093,4923,10016
5,Rolpa,Lungri RM,23631,135.23,32,1,33,4315,4156,8471
5,Rolpa,Sukidaha RM,20009,124.38,39,3,42,2488,2483,4971
5,Rolpa,Sunchhahari RM,16034,277.62,32,0,32,1646,1523,3169
5,Rolpa,Subarnawati RM,28213,156.55,42,6,48,4003,3899,7902
5,Rukum_East,"Putha Uttarganga
RM",17932,560.34,47,0,47,5190,5091,10281
5,Rukum_East,Bhume RM,18589,273.67,37,0,37,6477,6279,12756
5,Rukum_East,Sisne RM,16497,327.13,41,0,41,6243,5893,12136
5,Dang,Gadhawa RM,38592,358.57,32,12,44,4154,3830,7984
5,Dang,Ghorahi Sub-MP,156164,522.21,100,76,176,3474,3386,6860
5,Dang,Tulsipur Sub-MP,141528,384.63,83,76,159,2204,2070,4274
5,Dang,Dangisaran RM,21484,110.7,15,8,23,5394,5240,10634
5,Dang,Bangalachuli RM,24245,245.14,41,2,43,26733,25411,52144
5,Dang,Babai RM,27469,257.48,34,8,42,6798,6408,13206
5,Dang,Rajpur RM,25037,577.33,32,4,36,3487,3234,6721
5,Dang,Rapti RM,40763,161.07,31,17,48,6644,6274,12918
5,Dang,Lamahi MC,47655,326.66,28,25,53,3454,3195,6649
5,Dang,Shantinagar RM,25203,116.02,27,8,35,21875,21956,43831
5,Banke,Kohalpur MC,70647,184.26,40,26,66,8515,8118,16633
5,Banke,Khajura RM,50961,101.91,53,9,62,5484,5343,10827
5,Banke,Janaki RM,37839,63.32,32,1,33,3483,3366,6849
5,Banke,Duduwa RM,37460,91.1,36,2,38,8319,8311,16630
5,Banke,Narainapur RM,34942,172.34,40,2,42,12393,12246,24639
5,Banke,Nepalgunj Sub-MP,138951,85.94,97,61,158,4104,4305,8409
5,Banke,Baijnath RM,54418,141.67,42,15,57,24875,26284,51159
5,Banke,Raptisonari RM,59946,1041.73,58,8,66,8967,8430,17397
5,Bardiya,Gulariya MC,66679,118.21,48,6,54,8862,8086,16948
5,Bardiya,Geruwa RM,34871,78.41,33,5,38,10410,8687,19097
5,Bardiya,Thakurbaba MC,44361,104.57,34,12,46,10139,9512,19651
5,Bardiya,Badhaiya Tal RM,47868,115.19,43,8,51,6501,5573,12074
5,Bardiya,Bansgadhi MC,55875,206.08,42,13,55,10572,10478,21050
5,Bardiya,Barbardiya MC,68012,226.09,45,12,57,7255,6700,13955
5,Bardiya,Madhuvan MC,46437,129.73,33,8,41,7562,6980,14542
5,Bardiya,Rajapur MC,59553,127.08,38,8,46,8081,7367,15448
6,Rukum_West,Aathabiskot MC,33601,560.34,59,7,66,3532,3525,7057
6,Rukum_West,Chaurjhari MC,27438,107.38,43,1,44,3087,2925,6012
6,Rukum_West,Triveni RM,19504,85.49,44,0,44,3677,3635,7312
6,Rukum_West,Baphikot RM,18696,190.42,47,0,47,10296,10085,20381
6,Rukum_West,Musikot MC,32939,136.06,61,1,62,7595,7417,15012
6,Rukum_West,Sanibheri RM,22194,133.8,49,0,49,4775,4565,9340
6,Salyan,Kapurkot RM,18204,119.21,26,1,27,6741,6240,12981
6,Salyan,Kalimati RM,23005,500.72,52,1,53,5597,5265,10862
6,Salyan,"Kumankh Malika
RM",24972,177.28,49,2,51,3890,3636,7526
6,Salyan,Chhatreshwari RM,21452,150.69,40,3,43,3789,3530,7319
6,Salyan,Dhorchaur RM,13593,89.36,28,0,28,2570,2363,4933
6,Salyan,Tribeni RM,16624,119.11,30,3,33,4075,3947,8022
6,Salyan,Darma RM,19966,81.46,35,0,35,2916,2767,5683
6,Salyan,Bangadkupinde MC,36052,338.21,66,6,72,4100,3739,7839
6,Salyan,Bagchaur MC,34118,163.14,70,8,78,4868,4585,9453
6,Salyan,Sharada MC,33730,198.34,57,8,65,2316,2240,4556
6,Surkhet,Gurvakot MC,43765,228.62,74,6,80,4219,4224,8443
6,Surkhet,Chingad RM,17275,170.19,31,1,32,6869,6733,13602
6,Surkhet,Chaukune RM,25240,381.01,47,1,48,18146,18804,36950
6,Surkhet,Panchapuri MC,32231,329.9,58,1,59,4429,4310,8739
6,Surkhet,Baraha Taal RM,26802,455.09,50,1,51,3424,3273,6697
6,Surkhet,Birendranagar MC,100458,245.06,73,64,137,6968,6765,13733
6,Surkhet,Bheri Ganga MC,41407,256.2,48,1,49,4624,4476,9100
6,Surkhet,Lekbeshi MC,30295,180.92,46,1,47,6334,6292,12626
6,Surkhet,Simta RM,25845,241.64,70,1,71,4265,4027,8292
6,Dailekh,Aathbis MC,29227,168,58,3,61,6362,6173,12535
6,Dailekh,Gurans RM,22033,164.79,46,1,47,3376,3150,6526
6,Dailekh,Chamunda Bindrasaini MC,26149,90.6,52,3,55,4329,4110,8439
6,Dailekh,Thatikadh RM,18896,88.22,39,1,40,5267,5017,10284
6,Dailekh,Dungeswor RM,15883,105.19,31,0,31,7508,7067,14575
6,Dailekh,Dullu MC,41540,156.77,58,2,60,2727,2553,5280
6,Dailekh,Narayan MC,27037,110.63,45,6,51,4136,4125,8261
6,Dailekh,Naumule RM,20802,228.59,52,0,52,3722,3448,7170
6,Dailekh,Bhagwatimai RM,18778,151.52,39,1,40,4195,3923,8118
6,Dailekh,Bhairabi RM,21233,110.46,44,0,44,3896,3631,7527
6,Dailekh,Mahabu RM,19277,110.8,34,2,36,4309,4163,8472
6,Jajarkot,Kuse RM,20621,273.97,51,0,51,4289,4154,8443
6,Jajarkot,Chhedagad MC,35295,284.2,102,4,106,6164,5909,12073
6,Jajarkot,Junichande RM,21733,346.21,59,0,59,9199,8648,17847
6,Jajarkot,Tribeni Nalgad MC,25597,387.44,71,2,73,5732,5676,11408
6,Jajarkot,Barekot RM,18083,577.5,44,0,44,5172,5177,10349
6,Jajarkot,Bheri MC,33515,219.77,55,4,59,3406,3237,6643
6,Jajarkot,Shibalaya RM,15269,134.26,44,0,44,5782,5655,11437
6,Dolpa,Kaike RM,3576,466.6,14,0,14,180,138,318
6,Dolpa,"Chharka Tangsong
RM",1451,345.57,7,1,8,57,63,120
6,Dolpa,Jagadulla RM,2273,83.3,11,0,11,487,448,935
6,Dolpa,Thulibheri MC,8370,421.34,25,2,27,436,347,783
6,Dolpa,Dolpobuddha RM,2126,377.38,2,0,2,972,972,1944
6,Dolpa,Tripurasundari MC,10104,393.57,33,1,34,304,314,618
6,Dolpa,Mudkechula RM,5129,250.08,11,0,11,1397,1341,2738
6,Dolpa,Saiphoksundo RM,3099,123.07,10,1,11,1460,1471,2931
6,Jumla,Kankasundari RM,12977,225.39,19,0,19,4088,4015,8103
6,Jumla,Guthichaur RM,9870,427,6,2,8,1540,1376,2916
6,Jumla,Chandannath MC,19047,102.03,29,1,30,2307,2267,4574
6,Jumla,Tatopani RM,14638,525.56,25,1,26,2194,2096,4290
6,Jumla,Tila RM,13607,175.49,25,1,26,2627,2486,5113
6,Jumla,Patarasi RM,14571,814.07,16,1,17,2399,2339,4738
6,Jumla,Sinja RM,12395,153.29,14,1,15,2375,2260,4635
6,Jumla,Hima RM,10961,132.32,22,1,23,2620,2571,5191
6,Kalikot,Kalika RM,14080,97.32,28,1,29,3018,3018,6036
6,Kalikot,Khadachakra MC,20288,133.29,36,1,37,4891,4870,9761
6,Kalikot,Tilagufa MC,15766,262.56,33,1,34,2126,2060,4186
6,Kalikot,Naraharinath RM,21366,143.86,52,1,53,6267,5998,12265
6,Kalikot,Pachaljharna RM,12343,166.92,28,3,31,3530,3745,7275
6,Kalikot,Palata RM,15303,318.84,32,0,32,3799,3898,7697
6,Kalikot,Mahawai RM,8323,322.07,21,0,21,3817,3666,7483
6,Kalikot,Raskot MC,16272,59.73,25,2,27,3068,3061,6129
6,Kalikot,Satri Tribeni RM,12846,136.71,27,2,29,2754,2694,5448
6,Mugu,Khatyad RM,17116,281.12,43,1,44,3508,3279,6787
6,Mugu,Rara Chhayanath MC,20078,480.67,39,5,44,926,874,1800
6,Mugu,"Mugum
Karmarong RM",5396,2106.91,15,1,16,3129,2951,6080
6,Mugu,Soru RM,12238,365.8,44,1,45,3069,3000,6069
6,Humla,Adanchuli RM,7116,150.61,19,0,19,1394,1360,2754
6,Humla,Kharpunath RM,6011,880,16,0,16,969,925,1894
6,Humla,Chankheli RM,5517,1310.41,20,0,20,1207,1078,2285
6,Humla,Tanjakot RM,5964,159.1,19,0,19,864,787,1651
6,Humla,Namkha RM,3900,2419.64,17,0,17,1525,1425,2950
6,Humla,Sarkegad RM,9868,306.7,30,3,33,1822,1754,3576
6,Humla,Simkot RM,11597,785.89,23,4,27,1271,1187,2458
7,Bajura,Gaumul RM,8515,314.66,23,0,23,3462,3482,6944
7,Bajura,Chhededhaha RM,18575,135.08,31,1,32,3956,3791,7747
7,Bajura,Triveni MC,18363,170.32,36,4,40,3546,3367,6913
7,Bajura,Pandavgupha RM,9432,171.72,17,1,18,3350,3219,6569
7,Bajura,Badimalika MC,16818,276,25,3,28,1719,1571,3290
7,Bajura,Budhiganga MC,21677,59.2,33,10,43,1721,1523,3244
7,Bajura,Budhinanda MC,18776,232.48,30,7,37,1946,1742,3688
7,Bajura,Swamikartik RM,12784,110.55,26,1,27,2510,2242,4752
7,Bajura,Himali RM,9214,830.33,23,1,24,3727,3423,7150
7,Bajhang,Kanda RM,2182,1467.27,5,0,5,3816,3965,7781
7,Bajhang,Kedarsiuy RM,21307,113.91,52,1,53,7426,7105,14531
7,Bajhang,"Khaptad Chhana
RM",15893,113.52,41,1,42,4031,3689,7720
7,Bajhang,Chhabispathi Bhera RM,16296,116.34,41,0,41,2028,1963,3991
7,Bajhang,Jaya Prithvi MC,22191,166.79,54,7,61,5608,5147,10755
7,Bajhang,Talkot RM,11557,335.26,28,1,29,307,328,635
7,Bajhang,Thalara RM,17952,105.51,43,0,43,5628,5413,11041
7,Bajhang,Durgathali RM,12972,61.83,29,1,30,3751,3486,7237
7,Bajhang,Bungal MC,33224,447.59,85,1,86,2646,2564,5210
7,Bajhang,Masta RM,14951,109.24,32,0,32,1236,1403,2639
7,Bajhang,Bitthadchir RM,17154,86.15,32,1,33,2457,2400,4857
7,Bajhang,Surma RM,9022,270.8,16,0,16,3508,3433,6941
7,Achham,Kamalbajar MC,23738,120.78,47,0,47,3104,2657,5761
7,Achham,Chaurpati RM,25149,182.16,41,1,42,4396,4211,8607
7,Achham,Dhakari RM,21562,227.88,45,0,45,4713,4579,9292
7,Achham,Turmakhd RM,24940,232.07,55,2,57,5114,5091,10205
7,Achham,Panchadewal Binayak MC,27485,147.75,61,1,62,7019,6681,13700
7,Achham,Bannigadhi Jayagadh RM,17359,58.26,28,1,29,4506,4420,8926
7,Achham,Mangalsen MC,32331,220.14,51,2,53,6886,6542,13428
7,Achham,Mellekh RM,24670,134.78,34,1,35,5911,5548,11459
7,Achham,Ramaroshan RM,25166,173.33,46,1,47,6446,6068,12514
7,Achham,SaMChebagar MC,33788,166.71,71,2,73,6832,6716,13548
7,Doti,Adarsha RM,23945,128.47,32,5,37,4447,4293,8740
7,Doti,Ki Singh RM,20903,127.01,34,5,39,2447,2288,4735
7,Doti,Jorayal RM,20824,419.09,58,2,60,3321,3154,6475
7,Doti,Dipayal Silgadi MC,32941,126.62,44,6,50,5220,4947,10167
7,Doti,Purvichauki RM,22483,117.66,40,3,43,3345,3206,6551
7,Doti,Baddikedar RM,16720,332.55,40,0,40,3955,3725,7680
7,Doti,Bogatan RM,17902,300.22,43,0,43,3647,3703,7350
7,Doti,Sikhar MC,31801,285.37,68,3,71,3036,3063,6099
7,Doti,Sayal RM,19551,122.72,32,0,32,5630,5477,11107
7,Kailali,Kailari RM,47987,233.27,46,3,49,4989,4590,9579
7,Kailali,Godawari MC,78018,308.63,51,10,61,5872,5420,11292
7,Kailali,Gauriganga MC,55314,244.44,42,7,49,3634,3534,7168
7,Kailali,Ghodaghodi MC,75586,354.45,61,28,89,24932,26184,51116
7,Kailali,Chure RM,18924,493.18,42,0,42,9011,8240,17251
7,Kailali,Janaki RM,48540,107.27,29,2,31,11720,11528,23248
7,Kailali,Joshipur RM,36459,65.57,25,9,34,12901,11794,24695
7,Kailali,Tikapur MC,76084,118.33,35,33,68,6198,5264,11462
7,Kailali,"Dhangadhi Sub-
MP",147741,261.75,84,83,167,5753,5303,11056
7,Kailali,Bardagoriya RM,32683,77.26,17,5,22,5276,4579,9855
7,Kailali,Bhajani MC,51845,176.25,31,0,31,12348,11561,23909
7,Kailali,Mohanyal RM,22053,626.95,40,0,40,3817,3744,7561
7,Kailali,Lamkichuha MC,75425,225,46,21,67,15426,14845,30271
7,KanchaMCur,Krishnapur MC,56643,252.75,37,12,49,9232,8177,17409
7,KanchaMCur,Punarbash MC,53633,103.71,35,22,57,8768,7439,16207
7,KanchaMCur,Beldandi RM,21949,36.7,17,6,23,4035,3642,7677
7,KanchaMCur,Belauri MC,53544,123.37,35,10,45,19193,21511,40704
7,KanchaMCur,Bhimdatta MC,104599,171.8,61,71,132,11362,9911,21273
7,KanchaMCur,Mahakali MC,39253,56.84,26,16,42,3193,2852,6045
7,KanchaMCur,Laljhadi RM,22569,154.65,18,0,18,6530,6000,12530
7,KanchaMCur,Bedkot MC,49479,159.92,28,14,42,9275,8499,17774
7,KanchaMCur,Shuklaphanta MC,46834,162.57,36,13,49,7686,7340,15026
7,Dadeldhura,Ajayemeru RM,7066,148.9,33,3,36,3103,2883,5986
7,Dadeldhura,Amargadhi MC,21245,139.33,31,9,40,2899,2794,5693
7,Dadeldhura,Alital RM,18531,292.87,42,1,43,4510,4074,8584
7,Dadeldhura,Ganyapdhura RM,15093,135.65,25,5,30,2438,2190,4628
7,Dadeldhura,Navadurga RM,19957,141.89,30,5,35,2429,2195,4624
7,Dadeldhura,Parashuram MC,34983,414.07,64,9,73,3245,2955,6200
7,Dadeldhura,Bhageshor RM,14129,233.38,35,0,35,6587,6019,12606
7,Baitadi,Dilasaini RM,22924,125.28,57,2,59,5434,5067,10501
7,Baitadi,Dasharatha Chand MC,34575,135.15,57,10,67,4509,4189,8698
7,Baitadi,Dogadakedar RM,24632,126.38,60,1,61,4556,4382,8938
7,Baitadi,Pancheshwor RM,18766,120.41,34,0,34,4208,4070,8278
7,Baitadi,Patan MC,30435,219.26,65,3,68,3149,3110,6259
7,Baitadi,Purchaudi MC,39174,198.52,88,0,88,4953,4512,9465
7,Baitadi,Melauli MC,22545,119.43,46,1,47,8686,8451,17137
7,Baitadi,Shivanath RM,17115,81.65,36,0,36,3294,3147,6441
7,Baitadi,Sigas RM,21510,245.44,59,0,59,4471,4424,8895
7,Baitadi,Surnya RM,18549,124.52,38,2,40,3454,3285,6739
7,Darchula,Apihimal RM,6779,613.95,24,1,25,1226,1165,2391
7,Darchula,Duhun RM,10818,65.35,19,2,21,1309,1228,2537
7,Darchula,Naugad RM,15874,180.27,42,1,43,1489,1349,2838
7,Darchula,Byas RM,10347,839.26,25,2,27,2395,2279,4674
7,Darchula,Mahakali MC,21231,135.11,50,7,57,3976,4014,7990
7,Darchula,Marma RM,14956,208.06,43,0,43,2527,2343,4870
7,Darchula,Malikarjun RM,15581,100.82,46,0,46,2961,2801,5762
7,Darchula,Lekam RM,14838,83.98,46,1,47,3013,2899,5912
7,Darchula,Sailyashikhar MC,22060,117.81,51,3,54,4455,4159,8614
.,Darchula Total,.,132484,2344.61,346,17,363,23351,22237,45588
.,Grand Total,.,"26494504
(Including Other Population)","147181
(Inclding Remaing Area)",29035,6566,35601,3769124,3622400,7391524
